07 14 07 07 07 07 14 07 07 07 07 14 07 07 07 07 14 07 07 07 07 14 07 07 07 07 14 07 07 07 07 14 07 07 07 07 14 07 07 07 07 14 07 07 07 07 14 07 07 07
07 07 07 14 07 07 07 07 14 07 07 07 07 14 07 07 07 07 14 07 07 07 07 14 07 07 07 07 14 07 07 07 07 14 07 07 07 07 14 07 07 07 07 14 07 07 07 07 14 07
07 14 07 07 07 07 14 07 07 07 07 14 07 07 07 07 14 07 07 07 07 14 07 07 07 07 14 07 07 07 07 14 07 07 07 07 14 07 07 07 07 14 07 07 07 07 14 07 07 07
07 07 07 14 07 07 07 07 14 07 07 07 07 14 07 07 07 07 14 07 07 07 07 14 07 07 07 07 14 07 07 07 07 14 07 07 07 07 14 07 07 07 07 14 07 07 07 07 14 07
07 14 07 07 07 07 14 07 07 07 07 14 07 07 07 07 14 07 07 07 07 14 07 07 07 07 14 07 07 07 07 14 07 07 07 07 14 07 07 07 07 14 07 07 07 07 14 07 07 07
07 07 07 14 07 07 07 07 14 07 04 12 12 12 12 12 12 12 12 12 12 12 12 12 12 12 12 12 12 12 12 12 12 12 12 12 12 12 12 05 07 07 07 14 07 07 07 07 14 07
07 14 07 07 07 07 14 07 07 04 13 19 19 19 19 19 19 19 19 19 00 00 00 00 00 00 00 00 37 00 00 00 19 19 19 19 19 19 19 11 05 14 07 07 07 07 14 07 07 07
07 14 07 07 07 07 14 07 07 08 19 19 19 19 19 19 19 19 19 19 19 00 00 37 00 00 00 00 00 00 00 19 19 19 19 19 19 19 19 19 06 14 07 07 07 07 14 07 07 07
07 14 07 07 07 07 14 07 07 08 19 19 19 19 19 19 19 19 19 19 19 00 00 00 00 00 00 00 00 00 00 19 19 19 19 19 19 19 19 19 06 14 07 07 07 07 14 07 07 07
07 07 07 14 07 07 07 07 14 08 19 19 19 19 19 19 19 19 19 19 19 37 00 00 00 00 00 00 37 00 00 19 19 19 19 19 19 19 19 19 06 07 07 14 07 07 07 07 14 07
07 14 07 07 07 07 14 07 07 08 19 19 19 19 19 19 19 19 19 19 19 19 00 00 00 37 00 00 00 00 19 19 19 19 19 19 19 19 19 19 06 14 07 07 07 07 14 07 07 07
07 14 07 07 07 07 14 07 07 08 19 19 19 19 19 19 19 19 19 19 19 19 19 19 00 00 00 00 19 19 19 19 19 19 19 19 19 19 19 19 06 14 07 07 07 07 14 07 07 07
07 07 07 14 07 07 07 07 14 08 19 19 19 19 19 19 19 19 19 19 19 19 19 19 19 00 00 19 19 19 19 19 19 19 19 19 19 19 19 19 06 07 07 14 07 07 07 07 14 07
07 14 07 07 07 07 14 07 07 08 19 19 19 20 20 20 20 20 19 19 19 19 19 19 19 28 30 19 19 19 19 19 19 19 19 19 19 19 19 19 06 14 07 07 07 07 14 07 07 07
07 14 07 07 07 07 14 07 07 08 19 19 19 20 24 24 24 20 19 19 19 19 19 19 19 31 33 19 19 19 19 19 19 19 19 19 00 19 19 00 11 12 05 07 07 07 14 07 07 07
07 07 07 14 07 07 07 07 14 08 19 19 19 20 24 24 24 20 19 19 19 19 19 19 19 31 33 19 19 19 19 19 19 19 19 00 00 00 00 00 00 00 06 14 07 07 07 07 14 07
07 14 07 07 07 07 14 07 07 08 19 19 19 20 24 24 24 20 19 19 19 19 19 19 19 31 41 29 29 29 29 29 29 30 00 00 37 00 00 37 00 00 06 14 07 07 14 07 07 07
07 14 07 07 07 07 14 07 07 08 19 19 19 20 24 24 24 20 19 19 19 19 19 19 19 31 39 35 35 35 35 35 35 36 00 00 00 00 00 00 00 37 06 07 07 07 14 07 07 07
07 07 07 14 07 07 07 07 14 08 19 19 19 20 24 24 24 20 19 19 19 19 19 19 19 31 33 19 19 19 19 19 19 19 19 00 00 00 00 00 00 00 06 07 14 07 07 07 14 07
07 14 07 07 07 07 14 07 07 08 19 19 19 20 20 24 20 20 19 19 19 19 19 19 19 31 33 19 19 19 19 19 19 19 19 19 00 37 00 00 01 02 10 07 07 07 14 07 07 07
07 14 07 07 07 07 14 07 07 08 19 19 19 00 00 00 00 00 19 19 19 19 19 19 19 31 33 19 19 19 19 19 19 19 19 19 19 19 19 00 06 14 07 07 07 07 14 07 07 07
07 07 07 14 07 07 07 07 14 08 19 19 19 19 00 00 37 19 19 19 19 19 19 19 19 31 33 19 19 19 19 19 19 19 19 19 19 19 19 00 06 07 07 14 07 07 07 07 14 07
07 14 07 07 07 07 14 07 07 08 19 19 19 19 19 00 19 19 19 19 19 19 19 19 19 31 33 19 19 19 19 19 19 19 19 19 19 19 19 00 06 14 07 07 07 07 14 07 07 07
07 14 07 07 07 07 14 07 07 08 19 19 19 19 19 00 00 00 00 00 00 00 00 00 00 31 33 19 19 19 19 19 19 19 19 19 19 19 19 00 06 14 07 07 07 07 14 07 07 07
07 07 07 14 07 07 07 07 14 08 19 19 19 19 19 19 19 19 19 19 19 19 19 19 00 31 33 19 19 19 19 19 19 00 00 00 00 37 00 00 06 07 07 14 07 07 07 07 14 07
07 14 07 07 07 07 14 07 07 08 00 19 19 19 19 19 19 19 19 19 19 19 19 19 00 31 33 00 19 19 19 19 00 00 01 02 02 02 02 02 10 14 07 07 07 07 14 07 07 07
07 14 07 07 07 07 14 07 07 08 37 28 29 29 29 29 29 29 29 29 29 29 29 29 29 38 41 29 29 29 29 30 00 00 06 07 14 07 07 07 07 14 07 07 07 07 14 07 07 07
07 07 07 14 07 07 07 07 14 08 00 34 35 35 35 35 35 35 35 35 35 35 35 35 35 40 39 35 35 35 35 36 00 37 06 07 07 14 14 07 07 07 07 14 07 07 07 07 14 07
07 14 07 07 07 07 14 07 07 08 00 19 19 19 19 19 19 19 19 19 19 19 19 19 00 31 33 00 19 19 19 19 00 00 11 12 12 12 12 12 05 14 07 07 07 07 14 07 07 07
07 14 07 07 07 07 14 07 07 08 00 19 19 19 19 19 19 19 19 19 19 19 19 19 19 31 33 19 19 19 19 19 19 00 37 00 00 00 00 00 06 14 07 07 07 07 14 07 07 07
07 07 07 14 07 07 07 07 14 08 00 19 19 19 19 19 19 19 19 19 19 19 19 19 19 31 33 19 19 19 19 19 19 19 19 19 19 19 19 00 06 07 07 14 07 07 07 07 14 07
07 14 07 07 07 07 14 07 07 08 00 19 19 19 19 19 19 19 19 19 19 19 19 19 19 31 33 19 19 19 19 19 19 19 19 19 19 19 19 19 06 14 07 07 07 07 14 07 07 07
07 14 07 07 07 07 14 07 07 08 00 19 19 19 19 19 19 19 19 19 19 19 19 19 19 31 33 19 19 19 19 19 19 19 19 19 19 19 19 19 06 14 07 07 07 07 14 07 07 07
07 07 07 14 07 07 07 07 14 08 00 19 19 19 19 19 19 19 19 19 19 19 19 19 19 31 33 19 19 19 19 19 19 19 19 19 19 19 19 19 06 07 07 14 07 07 07 07 14 07
07 14 07 07 07 07 14 07 07 08 00 19 19 19 19 19 19 19 19 19 19 19 19 19 19 31 33 19 19 19 19 00 00 00 00 00 19 19 19 19 11 05 07 07 07 07 14 07 07 07
07 14 07 07 07 07 14 07 07 08 37 19 19 19 19 19 19 19 19 19 19 19 19 19 19 31 33 19 19 19 00 00 00 00 00 00 00 19 19 19 19 06 07 07 07 07 14 07 07 07
07 07 07 14 07 07 07 07 14 08 00 19 19 19 19 19 19 19 19 19 19 19 19 00 00 34 36 00 00 00 00 20 20 20 20 00 00 19 19 19 19 06 07 14 07 07 07 07 14 07
07 14 07 07 07 07 14 04 12 13 37 19 19 19 19 19 19 19 19 19 19 19 00 00 00 00 00 00 00 00 00 20 24 24 20 00 00 19 19 19 19 06 07 07 07 07 14 07 07 07
07 14 07 07 07 07 14 08 00 00 00 00 19 19 19 19 19 00 00 00 00 00 00 00 20 20 24 20 20 20 20 20 24 24 20 00 00 19 19 19 19 06 07 07 07 07 14 07 07 07
07 07 07 14 07 07 07 08 37 00 00 00 00 00 00 00 00 00 00 01 02 03 00 00 20 24 24 24 24 24 24 24 24 24 20 00 00 19 19 19 01 10 07 14 07 07 07 07 14 07
07 14 07 07 07 07 14 08 00 00 00 00 00 00 00 00 37 00 01 10 07 09 03 00 20 24 24 24 24 24 24 24 24 24 20 00 00 19 19 19 06 14 07 07 07 07 14 07 07 07
07 14 07 07 07 07 07 08 00 00 37 00 00 37 00 00 00 00 06 07 07 07 08 00 20 24 24 24 24 24 24 24 24 24 20 00 00 19 19 19 06 14 07 07 07 07 14 07 07 07
07 14 07 07 07 07 14 08 37 00 00 00 00 00 00 00 37 00 06 14 07 07 08 00 20 20 20 20 20 20 20 20 20 20 20 00 00 19 19 19 06 14 07 07 07 07 14 07 07 07
07 14 07 07 07 07 07 08 00 00 00 37 00 00 37 00 00 00 06 07 07 14 08 00 00 00 00 00 00 00 00 00 00 00 00 00 00 19 19 01 10 14 07 07 07 07 14 07 07 07
07 14 07 07 07 07 07 09 02 02 02 02 02 02 02 02 02 02 10 07 07 07 09 02 02 02 02 02 02 02 02 02 02 02 02 02 02 02 02 10 07 14 07 07 07 07 14 07 07 07
07 07 07 14 07 07 07 07 14 07 07 07 07 14 07 07 07 07 14 07 07 07 07 14 07 07 07 07 14 07 07 07 07 14 07 07 07 07 14 07 07 07 07 14 07 07 07 07 14 07
07 14 07 07 07 07 14 07 07 07 07 14 07 07 07 07 14 07 07 07 07 14 07 07 07 07 14 07 07 07 07 14 07 07 07 07 14 07 07 07 07 14 07 07 07 07 14 07 07 07
07 07 07 14 07 07 07 07 14 07 07 07 07 14 07 07 07 07 14 07 07 07 07 14 07 07 07 07 14 07 07 07 07 14 07 07 07 07 14 07 07 07 07 14 07 07 07 07 14 07
07 14 07 07 07 07 14 07 07 07 07 14 07 07 07 07 14 07 07 07 07 14 07 07 07 07 14 07 07 07 07 14 07 07 07 07 14 07 07 07 07 14 07 07 07 07 14 07 07 07
07 07 07 14 07 07 07 07 14 07 07 07 07 14 07 07 07 07 14 07 07 07 07 14 07 07 07 07 14 07 07 07 07 14 07 07 07 07 14 07 07 07 07 14 07 07 07 07 14 07