07 14 07 07 07 07 14 07 07 07 07 14 07 07 07 07 14 07 07 07 07 14 07 07 07 07 14 07 07 07 07 14 07 07 07 07 14 07 07 07 07 14 07 07 07 07 14 07 07 07
07 07 07 14 07 07 07 07 14 07 07 07 07 14 07 07 07 07 14 07 07 07 07 14 07 07 07 07 14 07 07 07 07 14 07 07 07 07 14 07 07 07 07 14 07 07 07 07 14 07
07 14 07 07 07 07 14 07 07 07 07 14 07 07 07 07 14 07 07 07 07 14 07 07 07 07 14 07 07 07 07 14 07 07 07 07 14 07 07 07 07 14 07 07 07 07 14 07 07 07
07 07 07 14 07 07 07 07 14 07 07 07 07 14 07 07 07 07 14 07 07 07 07 14 07 07 07 07 14 07 07 07 07 14 07 07 07 07 14 07 07 07 07 14 07 07 07 07 14 07
07 14 07 07 07 07 14 07 07 07 07 14 07 07 07 07 14 07 07 07 07 14 07 07 07 07 14 07 07 07 07 14 07 07 07 07 14 07 07 07 07 14 07 07 07 07 14 07 07 07
07 07 07 14 07 07 07 07 14 04 12 12 12 12 12 12 12 12 12 12 12 12 12 12 12 12 12 12 12 12 12 12 12 12 12 12 12 12 12 12 05 07 07 14 07 07 07 07 14 07
07 14 07 07 07 07 14 07 07 08 28 29 29 29 29 29 29 29 29 29 29 29 29 29 29 29 29 29 29 29 29 29 29 29 29 29 29 29 29 30 06 14 07 07 07 07 14 07 07 07
07 14 07 07 07 07 14 07 07 08 31 39 35 35 35 35 35 35 35 35 35 35 35 35 35 35 35 35 35 35 35 35 35 35 35 35 35 35 40 33 06 14 07 07 07 07 14 07 07 07
07 14 07 07 07 07 14 07 07 08 31 33 19 19 19 19 19 19 19 19 00 00 19 19 19 19 19 19 19 19 19 19 19 19 19 19 19 19 31 33 06 14 07 07 07 07 14 07 07 07
07 07 07 14 07 07 07 07 14 08 31 33 19 19 19 19 19 19 19 19 21 23 19 19 19 19 19 19 19 19 19 19 19 19 19 19 19 19 31 33 06 07 07 14 07 07 07 07 14 07
07 14 07 07 07 07 14 07 07 08 31 33 19 19 19 19 19 19 19 19 21 23 19 19 19 19 19 19 19 19 19 19 19 19 19 19 19 19 31 33 06 14 07 07 07 07 14 07 07 07
07 14 07 07 07 07 14 07 07 08 31 33 19 19 19 19 19 19 19 19 21 23 19 19 19 19 19 19 19 19 19 19 19 19 19 19 19 19 31 33 06 14 07 07 07 07 14 07 07 07
07 07 07 14 07 07 07 07 14 08 31 33 19 19 19 19 19 19 19 19 21 23 19 19 19 19 19 19 19 19 19 19 19 19 19 19 19 19 31 33 06 07 07 14 07 07 07 07 14 07
07 14 07 07 07 07 14 07 07 08 31 33 19 19 19 19 19 19 19 19 21 23 19 19 19 19 19 19 19 19 19 19 19 19 19 19 19 19 31 33 06 14 07 07 07 07 14 07 07 07
07 14 07 07 07 07 14 07 07 08 31 33 19 19 19 19 19 19 19 19 21 23 19 19 19 19 19 19 19 19 19 19 19 19 19 19 19 19 31 33 06 14 07 07 07 07 14 07 07 07
07 07 07 14 07 07 07 07 14 08 31 33 19 19 19 19 19 19 19 19 21 23 19 19 19 19 19 19 19 19 19 19 19 19 19 19 19 19 31 33 06 07 07 14 07 07 07 07 14 07
07 14 07 07 07 07 14 07 07 08 31 33 19 19 19 19 19 19 19 19 21 23 19 19 19 19 19 19 19 19 19 19 19 19 19 19 19 19 31 33 06 14 07 07 07 07 14 07 07 07
07 14 07 07 07 07 14 07 07 08 31 33 19 19 19 19 19 19 19 19 21 23 19 19 19 19 19 19 19 19 19 19 19 19 19 19 19 19 31 33 06 14 07 07 07 07 14 07 07 07
07 07 07 14 07 07 07 07 14 08 31 33 19 19 19 19 19 19 19 19 21 23 19 19 19 19 19 19 19 19 19 19 19 19 19 19 19 19 31 33 06 07 07 14 07 07 07 07 14 07
07 14 07 07 07 07 14 07 07 08 31 33 19 19 19 19 19 19 19 19 21 23 19 19 19 19 19 19 19 19 19 19 19 19 19 19 19 19 31 33 06 14 07 07 07 07 14 07 07 07
07 14 07 07 07 07 14 07 07 08 31 33 19 19 19 19 19 19 19 19 21 23 19 19 19 19 19 19 19 19 19 19 19 19 19 19 19 19 31 33 06 14 07 07 07 07 14 07 07 07
07 07 07 14 07 07 07 07 14 08 31 33 19 19 19 19 19 19 19 19 21 23 19 19 19 19 19 19 19 19 19 19 19 19 19 19 19 19 31 33 06 07 07 14 07 07 07 07 14 07
07 14 07 07 07 07 14 07 07 08 31 33 19 19 19 19 19 19 19 19 21 23 19 19 19 19 19 19 19 19 19 19 19 19 19 19 19 19 31 33 06 14 07 07 07 07 14 07 07 07
07 14 07 07 07 07 14 07 07 08 31 33 19 19 19 19 19 19 19 19 21 23 19 19 19 19 19 19 19 19 19 19 19 19 19 19 19 19 31 33 06 14 07 07 07 07 14 07 07 07
07 07 07 14 07 07 07 07 14 08 31 33 19 19 19 19 19 19 19 19 21 23 19 19 19 19 19 19 19 19 19 19 00 37 00 00 00 00 31 33 06 07 07 14 07 07 07 07 14 07
07 14 07 07 07 07 14 07 07 08 31 33 19 19 19 19 19 19 19 19 21 23 19 19 19 19 19 19 19 19 19 19 00 00 00 37 00 00 31 33 06 14 07 07 07 07 14 07 07 07
07 14 07 07 07 07 14 07 07 08 31 33 19 19 19 19 19 19 19 19 21 23 19 19 19 19 19 19 19 00 01 02 15 02 02 02 02 02 02 02 10 14 07 07 07 07 14 07 07 07
07 07 07 14 07 07 07 07 14 08 31 33 19 19 19 19 19 19 19 19 21 23 19 19 19 19 19 19 19 00 06 07 15 07 07 07 07 07 07 07 07 07 07 14 07 07 07 07 14 07
07 14 07 07 07 07 14 07 07 08 31 33 19 19 19 19 19 19 19 19 21 23 19 19 19 19 19 19 19 19 11 12 15 12 12 12 12 12 12 12 05 14 07 07 07 07 14 07 07 07
07 14 07 07 07 07 14 07 07 08 31 33 19 19 19 19 19 19 19 19 21 23 00 00 00 00 00 00 00 00 00 00 00 19 19 19 19 19 31 33 06 14 07 07 07 07 14 07 07 07
07 07 07 14 07 07 07 07 14 08 31 33 19 19 19 19 19 19 19 19 21 23 19 19 19 19 19 19 19 19 19 19 19 19 19 19 19 19 31 33 06 07 07 14 07 07 07 07 14 07
07 14 07 07 07 07 14 07 07 08 31 33 19 19 19 19 19 19 19 19 21 23 19 19 19 19 19 19 19 19 19 19 19 19 19 19 19 19 31 33 06 14 07 07 07 07 14 07 07 07
07 14 07 07 07 07 14 07 07 08 31 33 19 19 19 19 19 19 19 19 21 23 19 19 19 19 19 19 19 19 19 19 19 19 19 19 19 19 31 33 06 14 07 07 07 07 14 07 07 07
07 07 07 14 07 07 07 07 14 08 31 33 19 19 19 19 19 19 19 19 21 23 19 19 19 19 19 19 19 19 19 19 19 19 19 19 19 19 31 33 06 07 07 14 07 07 07 07 14 07
07 14 07 07 07 07 14 07 07 08 31 33 19 19 19 19 19 19 19 37 25 27 19 19 19 19 19 19 19 19 19 19 19 19 19 19 19 19 31 33 06 14 07 07 07 07 14 07 07 07
07 14 07 07 07 07 14 07 07 08 31 33 19 19 19 19 19 19 19 00 00 00 19 19 19 19 19 19 19 19 19 19 19 19 19 19 19 19 31 33 06 14 07 07 07 07 14 07 07 07
07 07 07 14 07 07 07 07 14 08 31 33 19 19 19 19 19 19 19 00 00 00 19 19 19 19 19 19 19 19 19 19 19 19 19 19 19 19 31 33 06 07 07 14 07 07 07 07 14 07
07 14 07 07 07 07 14 07 07 08 31 33 19 19 19 19 19 00 00 37 00 00 37 00 19 19 19 19 19 19 19 19 19 19 19 19 19 19 31 33 06 14 07 07 07 07 14 07 07 07
07 14 07 07 07 07 14 07 07 08 31 33 19 19 19 19 19 37 00 00 00 00 00 00 19 19 19 19 19 19 19 19 19 19 19 19 19 19 31 33 06 14 07 07 07 07 14 07 07 07
07 07 07 14 07 07 07 07 14 08 31 33 19 19 19 19 00 00 00 01 02 03 00 37 00 19 19 19 19 19 19 19 19 19 19 19 19 19 31 33 06 07 07 14 07 07 07 07 14 07
07 14 07 07 07 07 14 07 07 08 31 33 19 19 19 19 00 00 01 10 07 09 03 00 00 19 19 19 19 19 19 19 19 19 19 19 19 19 31 33 06 14 07 07 07 07 14 07 07 07
07 14 07 07 07 07 14 07 07 08 31 41 30 19 19 19 00 37 06 07 07 07 08 00 00 00 19 19 19 19 19 19 19 19 19 19 19 28 38 33 06 14 07 07 07 07 14 07 07 07
07 14 07 07 07 07 14 07 07 08 34 40 41 29 29 29 29 30 06 14 07 07 08 28 29 29 29 29 29 29 29 29 29 29 29 29 29 38 39 36 06 14 07 07 07 07 14 07 07 07
07 14 07 07 07 07 14 07 07 09 03 34 35 35 35 35 35 36 06 07 07 14 08 34 35 35 35 35 35 35 35 35 35 35 35 35 35 35 36 01 10 14 07 07 07 07 14 07 07 07
07 14 07 07 07 07 14 07 07 07 09 02 02 02 02 02 02 02 10 07 07 07 09 02 02 02 02 02 02 02 02 02 02 02 02 02 02 02 02 10 07 14 07 07 07 07 14 07 07 07
07 07 07 14 07 07 07 07 14 07 07 07 07 14 07 07 07 07 14 07 07 07 07 14 07 07 07 07 14 07 07 07 07 14 07 07 07 07 14 07 07 07 07 14 07 07 07 07 14 07
07 14 07 07 07 07 14 07 07 07 07 14 07 07 07 07 14 07 07 07 07 14 07 07 07 07 14 07 07 07 07 14 07 07 07 07 14 07 07 07 07 14 07 07 07 07 14 07 07 07
07 07 07 14 07 07 07 07 14 07 07 07 07 14 07 07 07 07 14 07 07 07 07 14 07 07 07 07 14 07 07 07 07 14 07 07 07 07 14 07 07 07 07 14 07 07 07 07 14 07
07 14 07 07 07 07 14 07 07 07 07 14 07 07 07 07 14 07 07 07 07 14 07 07 07 07 14 07 07 07 07 14 07 07 07 07 14 07 07 07 07 14 07 07 07 07 14 07 07 07
07 07 07 14 07 07 07 07 14 07 07 07 07 14 07 07 07 07 14 07 07 07 07 14 07 07 07 07 14 07 07 07 07 14 07 07 07 07 14 07 07 07 07 14 07 07 07 07 14 07